##########################################
#  C #a                           #      #
#    # $  dddd         #    #     #      #
#    ###################    #########    #
#a                                       #
#a         dddd                dddd      #
#    ###################   E#########    #
#                      #    #   $ #      #
#                      #          #      #
#    ###############   #    #######      #
#    #        ##   #   #    #            #
##  ##         #   #   #    #            #
#             ##   #   # dd #            #
#    ###########   #   ###################
#    #        $#   #a       #            #
#    #    ######   #a            #########
#    #             #P       #            #
#    #    ######   #  ###   #######      #
#    #         #   #    #         #      #
#    ###########   ######   #######      #
#    #    #    #                  #      #
#         #    #                  #      #
#    ######    #                  #E     #
#    #    #    #                  #      #
#    #  ###    #  V               #      #
#                                 #      #
#  ###  ####   ####  #  #### E    #      #
#    #     #   #$    # E   #      #      #
#   $#         #     #     #$     #      #
##########################################