.....#########################
#....#......................##
#....#......................##
#....###############........##
#........$#.................##
#....######.................##
#....##.....................##
#...........................##
#....############...........##
#....#......................##
#....#........##..##........##
#....#.........#..##........##
#.............##..##........##
#....###########..##........##
#...........................##
#..........###..............##
#.........##................##
#...........................##
#...........................##
#....#######................##
#...........#########.......##
#...........................##
#...........................##
#...........................##
#...........................##
#...........................##
#...........................##
#...........................##
#...........................##
##############################