........##################
.......................#
#......................#
#....#####.............#
#......................#
#.........#####........#
#......................#
#....#####.............#
#......................#
#......................#
#....#####.............#
#......................#
#.........#####........#
#......................#
#....#####.............#
#......................#
#......................#
#....#####.............#
#......................#
##########################
