     #####################################
#    #                            #      #
#    # $               #    #     #      #
#    ###################    #########    #
#                                        #
#                                        #
#    ###################    #########    #
#                      #    #   $ #      #
#                      #          #      #
#    ###############   #    #######      #
#    #        ##   #   #    #            #
######         #   #   #    #            #
#             ##   #   #    #            #
#    ###########   #   ###################
#    #        $#   #        #            #
#    #    ######   #             #########
#    #             #        #            #
#    #    ######   #  ###   #######      #
#    #         #   #    #         #      #
#    ###########   ######   #######      #
#    #    #    #                  #      #
#         #    #                  #      #
#    ######    #                  #      #
#    #    #    #                  #      #
#    #  ###    #                  #      #
#                                 #      #
#  ###  ####   ####  #  ####      #      #
#    #     #   #$    #     #      #      #
#   $#         #     #     #      #      #
##########################################